101111111111111111111
101000111010100000001
101110001000111011101
101011101010101010001
101010000010001010111
101010111010101010001
101010100010101010101
101000101110101010101
101010101010100010101
101010101010101010101
101010101010101111101
100010101000101000001
111111111111111011111